m.e.c.c.c.c.c.c.c.c.c.c.c.c.c.c.c.c.c.c.f.m..................l.....l....
.................................................m.....n.........n......
..8.x.s.s.s.s.D.s.s.H.s.s.N...N...s.s.w.6..........n.....l..n...........
.....L..0...................................n.................n.....n...
..8.v.t.t.t.t...t.t...7.t.........t.7.r.6.n.......n.e.c.c.c.f.....m...n.
........................................................................
..j.2.2.2.2.2.2.2.2.3.z.1.2.2.2.2.3.G...b.c.c.c.c.c.d.x.s.w.b.c.c.c.c.f.
........................................................................
..n.l..m.n......m.n.8.z.6.e.c.c.c.d.q.7.y.y.y.y.y.y.y.7.O.7.y.y.y.s.w.6.
n.......................................................................
..e.c.c.c.c.c.c.c.f.8.z.6.8.x.s.s.D.7.r.1.2.2.2.2.2.3.v.t.u.1.2.3.q.r.6.
........................................................................
..8.x.s.y.y.y.y.w.6.8.z.6.8.q.7.t...t.u.6.e.c.c.c.f.j.2.2.2.k.n.8.G...6.
........................................................................
n.8.q.r.1.2.2.3.z.6.8.z.6.8.G...g.i.i.i.a.d.x.s.w.b.c.c.c.c.c.c.d.q.r.6.
........................................................................
m.8.G...6.n...8.z.b.d.z.6.8.q.7.s.J.s.A...s.7.O.7.s.C.C.s.s.B.B.s.7.r.6.
........................................................................
..8.q.r.6..n..8.v.y.y.u.6.8.v.t.t...t.....t.t.t.t.t.....t.t.....t.7.r.6.
........................................................................
..8.q.r.6.l...j.2.2.2.2.k.j.2.2.2.2.2.2.2.2.2.2.2.2.2.2.2.2.2.2.3.I...6.
n.......................................................................
..8.I...b.c.c.c.c.c.c.c.f.e.c.c.c.f..n.m......n.m....n..l...n.m.8.q.r.6.
........................................................................
..8.q.7.N...N...s.s.s.w.b.d.x.s.w.6.n.e.c.c.c.c.c.c.c.c.c.c.c.c.d.K...6.
........................................................................
..8.v.t.........t.7.7.t.y.y.7.O.r.6...8.x.s.s.B.B.B.s.s.s.N...N...7.r.6.
........................................................................
n.j.2.2.2.2.2.2.3.q.r.1.2.3.v.t.u.6...8.q.7.t.......t.7.t.........t.u.6.
........................................................................
e.c.c.c.c.c.c.c.d.E...6.m.j.2.2.2.k.l.8.G...1.2.2.2.3.z.1.2.2.2.2.2.2.k.
........................................................................
8.x.s.s.A...A...s.7.r.b.c.c.c.c.c.c.c.d.q.r.6.n.m...8.z.b.c.c.c.c.c.c.f.
........................................................................
8.q.7.t.........t.t.t.y.y.y.y.y.y.y.y.y.t.u.6..n....8.v.y.y.y.y.y.s.w.6.
........................................................................
8.K...1.2.2.2.2.2.2.2.2.2.2.2.2.2.2.2.2.2.2.k.....n.j.2.2.2.2.2.3.q.r.6.
........................................................................
8.q.r.6.n.m..l.n.......n.l......n.m..........m...m.n........m.n.8.G...6.
........................................................................
8.q.r.6.n.l......m.n.n..l....l.n.........m.n.....l.n.l......l.n.8.q.r.6.
........................................................................
8.q.r.b.c.c.c.c.c.c.c.c.c.c.c.c.c.c.c.c.c.c.c.c.c.c.c.c.c.c.c.c.d.q.r.6.
........................................................................
8.q.7.s.J.s.s.H.s.s.D.B.B.B.s.s.C.C.s.s.N...N...s.s.s.s.H.s.s.F.s.7.r.6.
........................................................................
8.v.t.t...t.t...t.t.........t.t.....t.t.........t.7.7.t...t.t...t.t.u.6.
........................................................................
j.2.2.2.2.2.2.2.2.2.4.i.i.i.i.i.i.i.i.5.2.2.2.2.3.q.r.1.2.2.2.2.2.2.2.k.
........................................................................
e.c.c.c.c.c.c.c.f.n.8.x.s.s.N...s.s.w.6.n.l..n..8.E...6....n.l......n.m.
........................................................................
8.x.s.s.s.J.s.w.6...8.q.7.t.....t.7.r.6..n....n.8.q.r.6...n.e.c.c.c.f...
...M....................................................................
8.v.t.t.t...7.r.6.m.8.q.r.1.2.2.3.G...b.c.c.c.c.d.G...b.c.c.d.x.s.w.6.n.
........................................................................
o.i.i.i.i.h.E...6...8.K...6.n...8.q.7.s.J.s.s.H.s.7.7.y.y.y.y.7.O.r.6...
......................................................................m.
8.x.s.s.H.s.7.r.6...8.q.r.6..n..8.v.t.t...t.t...t.7.r.1.2.2.3.v.t.u.6...
........................................................................
8.q.7.t...t.t.u.6.m.8.q.r.6.m...j.2.2.2.2.2.2.2.3.q.r.6.n...j.2.2.2.k...
......................................................................n.
8.G...g.i.i.i.i.p...8.E...b.c.c.c.c.c.c.c.f.m.n.8.E...6..n.m........n...
..................n.....................................................
8.q.7.N...s.s.w.6...8.q.7.s.F.C.C.C.s.s.w.6.....8.q.r.b.c.c.c.c.c.c.c.f.
........................................................................
8.v.t.....t.7.r.6...8.v.t.t.........t.7.r.6.l...8.q.7.s.J.A...A...s.w.6.
........................................................................
j.2.2.2.2.3.K...6.n.j.2.2.2.2.2.2.2.3.q.r.6..n..8.v.t.t...........7.r.6.
........................................................................
e.c.c.c.f.8.q.r.6..n.m..........m.n.8.K...6.n...j.2.2.2.2.2.2.2.3.q.r.6.
........................................................................
8.x.s.w.6.8.E...b.c.c.c.c.c.c.c.c.c.d.q.r.b.c.c.c.c.c.c.c.c.c.c.d.G...6.
........................................................................
8.q.O.r.b.d.q.7.s.C.C.C.s.s.B.B.B.D.s.7.7.s.N...N...H.s.s.C.C.C.s.7.r.6.
........................................................................
8.v.t.t.y.y.t.t.t.......t.t.........t.t.t.t...........t.t.......t.t.u.6.
........................................................................
j.2.2.2.2.2.2.2.2.2.2.2.2.2.2.2.2.2.2.2.2.2.2.2.2.2.2.2.2.2.2.2.2.2.2.k.
........................................................................