e.c.c.c.c.c.c.c.d.S...b.c.c.c.c.c.c.c.f.......e.c.c.c.c.c.c.c.c.c.c.c.f.
........................................................................
8.x.y.y.y.y.y.y.y.7.7.y.y.y.y.y.y.y.w.6.....m.8.x.s.s.s.s.s.s.s.s.s.w.6.
........................................n...............................
8.z.1.2.2.2.2.2.3.q.r.1.2.2.2.2.2.3.z.6...n...8.q.7.t.t.t.t.t.t.t.7.r.6.
........................................................................
8.z.6....m....m.8.q.r.6.n.l.....m.8.z.6.......8.q.r.1.2.2.2.2.2.3.q.r.6.
.......n......................n..........l..............................
8.z.6........n..8.q.r.6..n........8.z.6.....n.8.q.r.6.e.c.c.c.c.d.q.r.6.
..........................................m.............................
8.z.6.....n.....8.q.r.6...........8.z.6.......8.q.r.6.8.x.s.s.s.s.7.r.6.
........l...............................................................
8.z.6........n..8.q.r.6........l..8.z.6..n....8.q.r.6.8.q.7.t.t.t.t.u.6.
.......n................U..................m............................
8.z.6.......m.n.8.q.r.6.........n.8.z.6.n.....8.q.r.6.8.q.r.1.2.2.2.2.k.
........................................................................
d.z.b.c.c.c.c.c.d.R...b.c.c.c.c.c.d.z.b.c.c.c.d.q.r.6.8.q.r.b.c.c.c.c.f.
........................................................................
P.7.s.s.s.s.s.s.Q.7.7.P.s.s.s.s.s.s.7.T.s.s.s.s.7.r.6.8.q.7.s.s.s.s.w.6.
...................0....................................................
..7.t.t.t.t.t.t...7.7...t.t.t.t.t.t.7...t.t.t.t.t.u.6.8.v.t.t.t.t.7.r.6.
........................................................................
3.z.1.2.2.2.2.2.3.S...1.2.2.2.2.2.3.z.1.2.2.2.2.2.2.k.j.2.2.2.2.3.q.r.6.
........................................................................
8.z.6.n.........8.q.r.6.n.......n.8.z.6.n...n.m........n........8.q.r.6.
.............n............n......................n...m......n...........
8.z.6..n........8.q.r.6........n..8.z.6..m.....n..........m...n.8.q.r.6.
..........m.n............m..............................................
8.z.6...........8.q.r.6.........m.8.z.6.e.c.c.c.c.c.c.c.c.c.c.c.d.q.r.6.
...........................n............................................
8.z.6........l..8.q.r.6..n........8.z.6.8.x.s.s.s.s.s.s.s.s.s.s.s.7.r.6.
.......n....................n...........................................
8.z.6....m....n.8.q.r.6........m..8.z.6.8.v.t.t.t.t.t.t.t.t.t.t.t.t.u.6.
........................................................................
8.z.b.c.c.c.c.c.d.q.r.b.c.c.c.c.c.d.z.6.j.2.2.2.2.2.2.2.2.2.2.2.2.2.2.k.
........................................................................
8.v.y.y.y.y.y.y.y.7.7.y.y.y.y.y.y.y.u.6....m.....n............n..m....n.
........................................n......n......n....n........n...
j.2.2.2.2.2.2.2.3.R...1.2.2.2.2.2.2.2.k...n.......m.....m....n..........
........................................................................