........................................................................
..l..................l......m...........n...m.............n........n....
n.........n.l............n........n.......n..........n......l....m......
......................n.............m...................................
c.c.c.c.c.c.c.c.c.c.f..........................n....m.e.c.c.c.c.c.c.c.f.
........................................................................
s.s.s.s.s.s.s.s.s.w.6....................n....m.......8.x.s.s.s.s.s.w.6.
O.........................m...........m.................................
t.t.t.t.t.t.t.t...r.6...n.......n.l...............m...8.q...t.t.t...r.6.
....................................................n...................
2.2.2.2.2.2.2.3.q.r.b.c.c.c.c.c.c.c.c.c.f..n.....n....8.q.r.1.2.3.q.r.6.
........................................................................
..........m.n.8.q...s.s.s.s.s.s.P.s.s.w.6...n.........8.q.r.6.n.8.E...6.
..l...............0.....................................................
n.....n..l....8.v.t.t.t.t.t.t.t...t...r.6.m.......n...8.q.r.6...8.q.r.6.
..............................................................m.........
e.c.c.c.c.c.c.9.i.5.2.2.2.2.2.2.2.3.q.r.6..........n..8.q.r.6...8.q.r.6.
................................................m...............8.......
8.x.s.s.Q.s.s.s.w.6......m........8.q.r.6..n..........8.q.r.6...8.q.r.6.
.......................n......................................l.........
8.q...t...t.t...r.6...........l.n.8.K...6...e.c.c.c.c.d.q.r.6...8.q.r.6.
........................................................................
8.q.r.1.2.2.3.q.r.b.c.c.c.c.c.c.c.d.q.r.6...8.x.s.s.s.s...r.6.n.8.q.r.6.
........................................................................
8.q.r.6.n...8.q...s.D.s.s.s.Q.s.s.s...r.6...8.q...t.t.t.t.u.6...8.q.r.6.
........................................................................
8.K...6..m..8.v.t.t...t.t.t...t.t.t.t.u.6...8.q.r.1.2.2.2.2.k.l.8.G...6.
..........................................l.............................
8.q.r.6.....j.2.2.2.2.2.2.2.2.2.2.2.2.2.k...8.q.r.6.e.c.c.c.c.c.d.q.r.6.
..........n.............................................................
8.q.r.6.....m............................n..8.q.r.6.8.x.s.H.s.s.s...r.6.
........................................................................
8.q.r.b.c.c.c.c.c.c.c.c.c.c.c.c.c.c.c.c.c.c.d.q.r.6.8.q.....t.t.t.t.u.6.
........................................................................
8.q...s.s.s.H.s.s.s.D.s.s.s.s.s.J.s.s.s.F.s.s...r.6.8.q.r.g.i.i.i.i.i.p.
........................................................................
8.v.t.t.t.t...t.t.t...t.t.t.t.t...t.t.t...t.t.t.u.6.8.v.t.y.y.y.y.s.w.6.
........................................................................
j.2.2.2.2.2.2.2.2.2.2.2.2.2.2.2.2.2.2.2.2.2.2.2.2.k.j.2.2.2.2.2.3.q.r.6.
........................................................................
e.c.c.c.c.c.c.c.c.c.c.c.c.c.c.c.c.c.c.c.c.c.c.c.c.f.............8.q.r.6.
....................................................n....n..............
8.x.s.F.s.s.s.s.s.D.s.s.s.s.s.H.s.s.s.s.s.J.s.s.w.6...m......n..8.q.r.6.
..........................................................m.............
8.q.....t.t.t.t.t...t.t.t.t.t...t.t.t.t.t...t...r.6..n.l....l.n.8.q.r.6.
........................................................................
8.q.r.1.2.2.2.2.2.2.4.i.i.i.i.i.i.5.4.i.i.i.h.q.r.6.e.c.c.c.c.c.d.q.r.6.
........................................................................
8.q.r.b.c.c.c.f.n...8.x.s.s.s.s.w.6.8.x.s.D.s...r.6.8.x.s.F.s.s.s...r.6.
.......................M................................................
8.q...H.s.s.w.6..m..8.v.t.t.t...r.6.8.q.....t.t.u.6.8.q.....t.t.t.t.u.6.
........................................................................
8.v.t...t...r.b.c.f.j.2.2.2.3.q.r.6.8.q.r.1.2.2.2.k.8.q.r.1.2.2.2.2.2.k.
........................................................................
j.2.2.2.3.q...s.w.6.n..l....8.K...6.8.q.r.6.n...m...8.q.r.6.n.m..n....m.
..................................................n.................n...
....m...8.v.t...r.b.c.f...n.8.q.r.6.8.q.r.6..m......8.q.r.6..n..n.l.....
.n....n.................n...............................................
........j.2.3.q...s.w.6.....8.q.r.6.8.q.r.b.c.c.c.f.8.q.r.b.c.c.c.c.c.f.
..m.....................................................................
n.......m.n.8.v.t...r.b.c.f.8.q.r.6.8.q...F.s.s.w.6.8.q...s.D.s.s.s.w.6.
........................................................................
e.c.c.c.c.c.9.5.3.q...s.w.6.8.I...6.8.v.t...t...r.6.8.v.t.t...t.t...r.6.
........................................................................
8.x.s.s.s.s.w.6.8.v.t...r.6.8.q.r.6.j.2.2.2.3.q.r.6.j.2.2.2.2.2.3.q.r.6.
........................................................................
8.q...t.t...r.6.j.2.3.I...6.8.q.r.b.c.c.c.f.8.q.r.6.n....m....n.8.q.r.6.
......................................................n.................
8.q.r.1.3.q.r.b.c.c.d.q.r.6.8.q...s.s.s.w.6.8.q.r.6..........m..8.I...6.
.....................................................m....m.............
8.K...6.8.v.t.y.y.y.y.t.u.6.8.v.t.t.t...r.6.8.K...6....n....l.n.8.q.r.6.
........................................................................
8.q.r.b.9.i.i.i.i.i.i.i.i.a.9.i.i.i.h.G...6.8.q.r.b.c.c.c.c.c.c.d.q.r.6.
........................................................................
8.q...s.s.H.s.s.s.s.J.s.s.s.s.s.D.s.s...r.6.8.q...s.s.s.s.s.s.F.s...r.6.
........................................................................
8.v.t.t.t...t.t.t.t...t.t.t.t.t...t.t.t.u.6.8.v.t.t.t.t.t.t.t...t.t.u.6.
........................................................................
j.2.2.2.2.2.2.2.2.2.2.2.2.2.2.2.2.2.2.2.2.k.j.2.2.2.2.2.2.2.2.2.2.2.2.k.
........................................................................