................n.......................................................
...l......m.......n.........m....n......n.......n.....n......m.....n....
.n......n......n....m...l.n....l......l....l..n...m.....l..n.....m...n..
........................................................................
..e.c.c.c.c.c.c.c.c.c.c.c.c.c.c.c.c.c.c.c.c.c.c.c.c.c.c.c.c.c.c.c.c.c.f.
........................................................................
..8.x.s.s.s.s.s.s.s.s.s.s.s.s.s.P.s.s.s.F.s.s.s.D.s.s.s.F.s.s.s.J.s.w.6.
.....L.0................................................................
..8.v.t.t.t.t.t.t.t.t.t.t.7.t.t...t.7.t...T.7.t...t.7.t...t.7.t...W.r.6.
........................................................................
..j.2.2.2.2.2.2.2.2.2.2.3.z.1.2.2.3.z.g.i.h.z.g.i.h.z.g.i.h.z.g.i.h.z.6.
........................................................................
...n.....m..l...m...m.n.8.z.6.n...8.q.s.J.s.7.s.H.s.7.s.D.s.7.s.H.s.r.6.
.m...n..................................................................
........e.c.c.c.c.c.c.c.d.z.6..m..8.v.t...t.t.t...U.t.t...V.t.t...7.r.6.
........................................................................
.....l..8.x.s.s.s.s.y.y.y.u.6.e.c.9.i.i.i.i.i.5.2.2.2.2.2.2.2.2.3.q.r.6.
.n......................................................................
......Z.8.q.Y.7.7.r.1.2.2.2.k.8.x.s.y.y.y.y.w.b.f.n.....n.......8.q.r.6.
....................................................m.......m...........
...m....8.v.t.t.t.u.6.n.m.....8.q.r.1.2.2.3.q.w.6........m....n.8.q.r.6.
.....n..................................................................
........j.2.2.2.2.4.a.c.c.c.c.d.q.r.b.c.c.d.R...b.c.c.c.c.c.c.c.d.q.r.6.
........................................................................
e.c.c.c.c.f.n.m...8.x.s.s.H.s.s.7.7.P.s.s.Q.7.7.Q.C.C.C.F.s.s.J.s.7.r.6.
........................................................................
8.x.s.s.w.6..n....8.q.7.t...t.7.7.t...7.t...7.7...........t.t...t.7.r.6.
.......M................................................................
8.q.7.t.u.6.......8.q.r.1.2.3.S...1.3.z.1.3.S...1.2.2.2.4.i.i.i.h.X...6.
............m...........................................................
8.q.r.1.2.k.....l.8.R...6.n.8.q.r.6.8.z.6.8.q.r.6.n.m...8.x.s.s.s.7.r.6.
........................................................................
8.q.r.b.c.c.c.c.c.d.q.r.6...8.I...b.d.z.b.d.q.r.b.c.c.f.8.q.O.O.O.O.r.6.
........................................................................
8.q.7.s.s.s.s.s.Q.s.7.r.b.c.d.q.7.s.P.7.s.Q.7.7.P.s.w.6.8.v.t.t.t.t.u.6.
........................................................................
8.v.t.t.t.t.t.t...t.t.t.y.y.y.t.t.t...t.t...t.t...t.u.6.j.2.2.2.2.2.2.k.
........................................................................
j.2.2.2.2.2.2.2.2.2.2.2.2.2.2.2.2.2.2.2.2.2.2.2.2.2.2.k.n.m......n.m....
........................................................................