n.l.....l.....l..........l...m.n..........m.e.c.c.c.c.c.c.c.c.c.c.c.c.f.
........................................n...............................
..e.c.c.c.c.c.c.c.c.c.c.c.c.c.f.m...n.......8.x.s.s.s.s.s.s.s.D.s.s.w.6.
.........................................n..............................
..8.x.s.s.s.s.s.s.s.s.s.s.s.w.6......n......8.q.7.t.t.t.t.t.t.t.t.7.r.6.
.....L..0...............................................................
..8.v.t.t.t.t.t.t.t.t.t.t.7.r.6..n..m....l..8.q.r.1.2.2.2.2.2.2.3.q.r.6.
........................................................................
..j.2.4.i.i.i.i.i.5.2.2.3.q.r.6.n.......l.n.8.q.r.6.e.c.c.c.c.c.d.G...6.
........................................................................
....n.8.x.y.y.y.w.b.c.f.8.q.r.b.c.c.c.c.c.c.d.q.r.6.8.x.s.s.H.s.s.7.r.6.
........................................................................
...m..8.z.1.2.3.q.s.w.6.8.q.7.s.s.s.s.s.s.s.s.7.r.6.8.q.7.t.t.t.t.t.u.6.
...................M....................................................
......8.z.6.m.8.v.t.u.6.8.v.t.t.t.t.t.t.t.t.t.t.u.6.8.q.r.1.2.2.2.2.2.k.
........................................................................
..l.n.8.z.6.n.j.2.2.2.k.j.2.2.2.2.2.2.2.2.2.2.2.2.k.8.q.r.6.n.m.......n.
....................................................................m...
..e.c.d.z.b.c.c.c.c.c.c.f.m.n.l...n.m......n.l....m.8.K...6..n..........
n....................................................................n..
..8.x.s.7.s.s.s.s.s.s.w.6.e.c.c.c.c.c.c.c.c.c.c.c.c.d.q.r.b.c.c.c.f.....
......................................................................m.
m.8.v.t.t.t.t.t.t.t.7.r.6.8.x.s.s.s.B.B.B.B.s.s.s.s.s.7.7.s.s.s.w.6.....
........................................................................
..o.i.i.i.i.i.i.i.h.q.r.6.8.q.7.t.t.........t.t.t.t.t.t.t.t.t.t.r.6.....
........................................................................
..8.x.s.s.s.s.s.A...7.r.6.8.q.r.1.2.2.2.2.2.2.2.2.2.2.2.2.2.2.3.z.6..m..
........................................................................
..8.q.7.t.t.t.t.....t.u.6.8.q.r.6.m....n....m......m......m.n.8.z.6.n...
......................................................................n.
..8.q.r.1.2.2.2.2.2.2.2.k.8.q.r.6.....n.m...........l.......e.d.z.b.f...
.............................................n..........................
..8.q.r.b.c.c.c.c.c.c.c.c.d.q.r.6..................n.m......8.x.7.w.6...
..............................................n.m.......n...............
..8.q.7.s.s.C.C.C.C.s.s.s.s.7.r.6.......n...................8.q.7.r.6...
..........................................m..............n..............
..8.v.t.t.t.........t.t.t.t.t.u.6..n..........l.....l.......8.v.t.u.6.l.
n....................................n..................l...............
..j.2.2.2.2.2.2.2.2.2.2.2.2.2.2.k.n....l.....m.....n......l.j.2.2.2.k..n
........................................................................